WWWWWWWWWWWWWWWWWWWWWWWWWWWWWWWWWWWWWWWWWWWWWWWWWWWWWWWWWWWWWWWWWWWWWWWWWWWWWWWWWWWWWWWWWWWWWWWWWWWWWWWWWWWWWWWWWWWWWWWWWWWWWWWW
WWWWWWWWWWWWWWWWWWWWWWWWWWWWWWWWWWWWWWWWWWWWWWWWWWWWWWWWWWWWWWWWWWWWWWWWWWWWWWWWWWWWWWWWWWWWWWWWWWWWWWWWWWWWWWWWWWWWWWWWWWWWWWWW
WWWWWWWWWWWWWWWWWWWWWWWWWWWWWWWWWWWWWWWWWWWWWWWWWWWWWWWWWWWWWWWWWWWWWWWWWWWWWWWWWWWWWWWWWWWWWWWWWWWWWWWWWWWWWWWWWWWWWWWWWWWWWWWW
WWWWWWWWWWWWWWWWWWWWWWWWWWWWWWWWWWWWWWWWWWWWWWWWWWWWWWWWWWWWWWWWWWWWWWWWWWWWWWWWWWWWWWWWWWWWWWWWWWWWWWWWWWWWWWWWWWWWWWWWWWWWWWWW
WWWWWW______WWWWWWWWWWWW_______WWWWWWWWWWWWWWW________WWWWWWWWWWWWWWWWWWWWWWWWWFFFFF___WWWWWWWWWWWWWW__________WWWWWWWWWWWWWWWWW
WWWWW_PPFFFF__WWWWWWWW__PPPPPPP__WWWWWWWWWWW__PPPPPPPP____WWWWWWWWWWWWWWWWWWFFFFFFFFPM_WWWWWWWWWMMMMMMMPPPPPPPP____WWWWWWWWWWWWW
WWWW_PPFFFFFFP_WWWWW__PPPPFFFFFPP_WWWWWWWWW_PPPPPFFFFFPPPP__WWWWWWWWWWWWWWFFFFFFFFFPP_WWWWWWWWWMMMMPPPPPPPPPPPPPPPP_WWWWWWWWWWWW
WWWW_FFFFFFFFFP_____PPPPPFFFFFFFFP_WWWWWWWW_PPPPFFFFFFFFFPPP_WWWWWWWWWWWWFFFFFFFFFFMMWWWWWWWWWMMMPPPPPPPPPPPPPPPPPPP___WWWWWWWWW
WWWWFFFFFFPPPPPMMMPPPPPPFFFFFFFFFFP_WWWWWW_PPPPFFFFFFFFFFPPPP_WWWWWWWWWWWFFFFFFFFFMMMWWWWWWWMMMPPPPPPPPPFFFFFFFFPPPPPPP_WWWWWWWW
WWWWFFFFFPPPPPMMMMMPPPPPFFFFFFFFFFPP__WW__PPPFFFFFWWWFFFFFPPP_WWWWWWWWWWFFFFFFFFFMMMWWWWWWWMMMPPPPPPPPFFFFFFFFFFFFPPPPPP_WWWWWWW
WWWWFFFPPPPPMMMMMMMMPPPFFFFFFFFFFFFFPP__PPPPPFFFFWWWWWFFFPPP_WWWWWWWWWMMMFFFFFFFMMMWWWWWWW_PPPPPPPPPPFFFFFFFFFFFFFFPPPPP_WWWWWWW
WWWW_PPPPPMMMMMFFFFMMMMFFFFFFFFFFFFPPPPPPPPPFFFFFFWWWPPPPPP_WWWWWWWWWMMMFFFFFFFFFMMMWWWWWWW_PPPPPPPPFFFFFFMMMMMFFFFFFPPPP_WWWWWW
WWWW_PPPMMMMFFFFFFFFFMMMFFFFFFFFFFFFFPPPPPPFFFFFFWWWPPPPPPP_WWWWWWWWWWMMMFFFFFFFFFMMMWWWWW_PPPPPPPFFFFFFMMMFFFMMMFFFFFFPP_WWWWWW
WWWW_PPPMMFFFFFFFFFFFFMMFFFFFFDDDDFFFFFPPPPPFFFFFFFPPPPPPP_WWWWWWWWWFFFMMMFFFFFFFFFFMMWWWW_PPPPPPPFFFFFMMFFFFFFMMFFFFFFFPP_WWWWW
WWWW__PPPFFFFFFFFFFFFMMMFFFFFDDDDDDFFFFFFPPPPPFFFFFFPPPPP_WWWWWWWWWFFFMMMMFFFFFFFFFFFMMWWWW_PPPPPPFFFFFFFFFFPFFFMMFFFFFFFFWWWWWW
WWWWWW_PPPFFFFFFFFFFFFMMMFFFDDDDDDDDFFFFFFPPPPPFFFFFFFPP_WWWWWWWWWWFFFFMMMMFFFFFFFFFFMMWWWWW_PPPPPPFFFFFFFFFFFFFFFFFFFFFFFFWWWWW
WWWWWWW_PPPPFFFFFFFFFFMMMMFFDDDDSDDDFFFFFPPPPPPFFFFFFFPPP__WWWWWWWFFFFFMMMMFFFFFFFFFFFMWWWWW_PPPPPPPFFFFFFFFFFFFFFFFFFFFFFFFWWWW
WWWWWWWW_PPPPPPPFFFFFFFMMMMFFDDDDDDDFFFFFFPPPPPPFFFFFFFPPPP_WWWWWFFFFFFFMMMMMMFFFFFFFFMMWWWW_PPPPPPPPPFFFFFFFFFFFFFFFFFFFFFFWWWW
WWWWWWWWWFFFFPPPPPFFFFFFMMMMFFFDDDDFFFFFFFFPPPPFFFFFFFFPPPPP_WWWFFFFFFFFFMMMMMMFFFFFFFMMMWWWW_PPPPPPPPPPFFFFFFFFFFFFFFFFFFFFWWWW
WWWWWWWWFFFFFPPPPPPFFFFFFFMMMFFFFFFFFFFFFFPPPPPPFFFFFFFFPPPP_WWFFFFFFFPPPPPPPMMMFFFFFFFMMMWWWW__PPPPPPPPPFFFFFFFFFFFFFFFFWWWWWWW
WWWWWWWWWWFFPPPPPPPFFFFFFPPPPFFFFFFFFFFFFFPPPPPFFFFFFFFFFPPP_WWFFFFPPPPPPPPPPPPMMMMFFFFFMMMWWWWWFFPPPPPPPFFFFFFFFFFFFWWWWWWWWWWW
WWWWWWWFFFFFFPPPPPPPFFFFPPPPPFFFFFFFFFFFFPPPPPFFFFFFFFFFPPPPP_WW_PPPPPPPPPPPPPPPPMMMFFFFFMMMWWFFFPPPPPPPFFFFFFFFMMMMWWWWWWWWWWWW
WWWWWWFFFFFFFFFPPPPPPPPPPPPPFFFFFFFFFFFFFPPPPPPFFFFFFFFPPPPPPP_WWPPPPPPPPPPPPPPPPPMMMMFFFFWWWFFFFPPPPPPPFFFFMMMMMMFFFFWWWWWWWWWW
WWWWWWFFFFFFFFFPPPPPPPPPPPPPFFFFFFFFFFFFFFPPPPPPFFFFFFPPPPPPPPPPWPPPPPPFFFFFFPPPPPPMMMMFFFFFFFFFPPPPPPPFFMMMMMMMFFFDDD_WWWWWWWWW
WWWWWFFFFFFFFFFFPPPPPPPPPPPPPPFFFFFFFFFFFFPPPPPPPFFFPPPPPPPPPPPPWWPPPPFFFFFFFFPPPPPPMMMMMMMMMMFFWPPPPPFFMMMMMFFFFFDDDDD__WWWWWWW
WWWWFFFFFFFFFFFFPPPPPPPPPPPPPPPFFFFFFFFFFPPPPPPPPPPPPPPPPPPPPPPPPWPPPFFFFFFFFFFPPPPPFFMMMMMMMMMWWPPPPPFMMMMMMDDDDDDDDDDDD_WWWWWW
WWWWFFFFFFFFFFFFFPPPPPPPPPPPPPPPPFFFFFFFPPPPPPPPPPPPPPPPPPPPPPPPPWPPFFFFFPPPPFFFPPPFFFFFFFPPPWWWWWPPPPPMMMMMDDDDDDDDDDDDDD__WWWW
WWWWFFFFFFFFFFFFFFPPPPPPPWWWPPPPPPPFFFFPPPPPPPPPPPPPPPFFFFPPPPPPPWWFFFFPPPPPPFFFFPPPFFFFFPPPPPWWWWPPPPPPMMMDDDDDDDDDDFFDDDD_WWWW
WWWWFFFFFFFFFFFFFFFPPPPWWWWWWWPPPPPPFFFFPPPPPPPPPPFFFFFFFFFPPPPPPPWWFFFPPPPPPPFFFFPPPPFFPPPPPPPWWWWPPPPPPPPDDDDDDDDDFFFFDDD_WWWW
WWWWFFFFFFFFFFFFFFFFPPWWWWWWWWWPPPPPFFFFPPPPPPPPFFFFFFFFFFPPPPPPPPPWWFFFPPPPPPPFFFFPPPPPPPPPPPPPWWWWPPPPPPPDDDDDDDDDFFFFDDD_WWWW
WWWWFFFFFFFFFFFFFFFFFWWWWWWWWWWPPPPFFFFPPPPPPPPFFFFFFFFFFPPPPPPPPPPPWWFFFPPPPPFFFFFPPPPPPPFFFFFFFWWWPPPPPPPDDDDDDDDDDFFDDDD_WWWW
WWWWWWFFFFFFFFFFFFFFFWWWWWWWWWMMMFFFFFFPPPPPPPFFFFFFFFFFPPPPPPPPPPPPPWWWWWFFFFFFFFFFPPPPPFFFFFFFWWWWWPPPPPPPDDDDDDDDDDDDDD_WWWWW
WWWWWWWFFFFFFFFFFFFFWWWWWWWWWMMMMMMMFFPPPPPPFFFFFFFFFFFFPPPPPPPPPPPPPPPPWWWWWFFFFFFFFPPPPPFFFFFWWWWWPPPPPPPPPDDDDDDDDDDDD_WWWWWW
WWWWWWWWWWWWFFFFFFFWWWWWWMMMMMMMMMMMMPPPPPPPFFFFFFFFFFFFFPPPPPPPPPPPPMMMMWWWWWFFFFFFFPPPPPPFFFWWWWWPPPPPPPPPPPDDDDDDDDD__WWWWWWW
WWWWWWWW_PPWWWFFFFWWWWWMMMMMMMMMMMMMMMPPPPPFFFFFFFFFMMMMMMPPPPPPPPPMMMMMWWWWWWWFFFFFFFPPPPPPWWWWWWPPPPPPPPPPPPPPDDDDDD_WWWWWWWWW
WWWWWWW_PPPPPWFFWWWMMMMMMMMMMMMMMMMMPPPPPPFFFFFFFMMMMMMMMMMPPPPPPMMMMMMWWWWWWWWWFFFFFFPPPPPPPWWWWWWPPPPPPPPPPPPPPPPPP_WWWWWWWWWW
WWWWWW_PPPPPPWWWWWPPPPMMMMMMMMMMMMPPPPPPPPPFFFMMMMMMMMMMMMMMPPPPPMMMMMMMWWWWWWWFFFFFFPPPPPPPPWWWWWWWPPPPPPPPPPPPPPPPPP__WWWWWWWW
WWWWWW_PPPPPPPPPPPPPPPPPPMMMMMMMPPPPPPPPPPPPMMMMMMMPPPPMMMMMMFFFMMMMMMMMMWWWWWFFFFFFFFPPPPPPPPWWWWWPPPPPPPPPPPPPPPPPPFFFFWWWWWWW
WWWWWW_PPPPPPPPPPPPPPPPPPPPMMMMPPPPPPPPPPPPMMMMPPPPPPPPPPPMMFFFFFFFFFFMMMMWWWFFFFFFFFFFPPPPPPPPWWWPPPPPPPPPPPPPPPPPFFFFFFFWWWWWW
WWWWWWW_PPPPPPPPPPPPPPPPPPPPMMPPPPPPPPPPPPPPPPPPPPPPPPPPPPPMMFFFFFDDDDDMMMMMMMFFFFFFFFPPPPPPPPPWWPPPPPPPPPPPPPPPPPFFFFFFFFFWWWWW
WWWWWWWW_PPFFFFPPPPPPPPPPPPPWWPPPPPPPPPPPPPFFFFFFFPPPPPPPPMMMMFFDDDDDDDDDMMMMMMFFFFFFPPPPPPPPPWWPPPPPMMMMPPPPPPPPFFFFFFFFFFFWWWW
WWWWWWFFFFFFFFPPPPPPPPPPPPPWWWWPPPPPPPPPPPFFFFFFFFFFFPPPPPPMMMM___DDDDDDSSSFFFFFFFFFPPPPPPP___W_PPFFMMMMMMPPPPPPFFFFFFFFFFFWWWWW
WWWWWFFFFFFFPPPPPPPPPPPPPPPWWWWWPPPPPPPPFFFFFFFFFFFFFFPPPPPPP_WWWW___DDSSSSSFFFFFFFFFPPP___WWWWFFFFFMMMMMMMPPPPFFFFFFFFFFFFWWWWW
WWWWFFFFFFFPPPPPPPPPPFFFFFWWWWWPPPPPPPPFFFFFFFFFFFFFFPPPPPP__WWWWWWWW_SSSSSSSFFFFFFF____WWWWWWWFFFFFFFFMMMMMPPFFFFFFFFFFFFWWWWWW
WWWWFFFFFPPPPPPPPPFFFFFFFWWWWWWPPPPPPPFFFFFFFFFFFPPPPPPPPP_WWWWWWWWW__SSSSSSFFFFFFFWWWWWWWWWWWWWFFFFSSSSMMMMFFFFFFFFFFFFFWWWWWWW
WWWWFFFFPPPPPPPFFFFFFFFWWWWWWWWWPPPPPPPFFFFFFFPPPPPPP_____WWWWWWWWWWWW___SSFFFFFFWWWWWWWWWWWWWWWWW___SSSSSMMMMMFFFFFFWWWWWWWWWWW
WWWWFFFFFPPPPPFFFFFWWWWWWWWWWPPPPPPPPPPPFFFFPPPPPPP__WWWWWWWWWWWWWWWWWWWWFFFFFWWWWWWWWWWWWWWWWWWWWWWW__SSSSMMMMMMMWWWWWWWWWWWWWW
WWWWWFFFFFPPPFFFFWWWWWWWWWWWPPPPPPPPPPPPPPPPPPPPP__WWWWWWWWWWWWWWWWWWWWWWWWWWWWWWWWWWWWWWWWWWWWWWWWWWWW____SSSMMMWWWWWWWWWWWWWWW
WWWWWWFFFFFFFFFFWWWWWWWWWPPPPPPPPPPPPPPPPPPPPPP__WWWWWWWWWWWWWWWWWWWWWWWWWWWWWWWWWWWWWWWWWWWWWWWWWWWWWWWWWW_S_MMWWWWWWWWWWWWWWWW
WWWWWWFFFFFFFFFWWWWWWWWWFFFFFFPPPPPPPPPPPPPPP__WWWWWWWWMMMWWWWWWWWWWWWWWWWWWWWWWWWWWWWWWWFFFFFFWWWWWWWWWWWWWWWWWWWWWWWWWWWWWWWWW
WWWWWWWWFFFFFFFFFWWWWWWFFFFFFFFPPPPPPPPPPPPP_WWWWWWWWMMMMMMWWWWWWWWWWWWWWWWWWWWWWWWFFFFFFFFFFFP____WWWWWWWWWWWWWWWWWWWW____WWWWW
WWWWWWWFFFFFFFFFFFWWWWWWWWFFFFFFFPPPPPPPPPP_WWWWWWW__SMMMMMMMWWWWWWWWWWWWWWWWWFFFFFFFFFFFFFFFPPPPPP___WWWWWWWWWWWWWWWW_PPPP_WWWW
WWWWWWFFFFFFFFFFFFFWWWWWWWWFFFFFFFFPPPPPPP_WWWWWWWMSSSMMMMMMMMWWWWWWWWWWWWW___DFFFFFFFFFFFFFFPPPPPPPPP___WWWWWWWWWWWW_PPPPP_WWWW
WWWWWWWFFFFFFFFFFFWWWWWWWWWWFFFFFFFFPPPPPPP_WWWWWMMSSSDDMMMMMMMWW___W___WW_DDDDDDFFFFFFFFFFFFFPPPPPPPPPPP___S_WWWWWW_PPPPPP_WWWW
WWWWWWWFFFFFFFFFFMMMMWWWWWFFFFFFFFFFFPPPPPP_WWWWMMMMMMMDDMMMMDD__D_WWWW___DDDDDDDDFFFFFFFFFFFFFFPPPPPPPPPPPSS_WWWWWFFFFPPPP_WWWW
WWWWWWWWWFFFFFFMMMMMMMMMMMMMFFFFFFFFPPPPPPP_WWWWWMMMMDDDDMMMDDDDDMMWWWWMMDDDDDDDDDDFFFFFFFFFFFFFFFFFPPPPPPPPPP__WWFFFFFFFFFFWWWW
WWWWWWWW_PFFMMMMMMMMMMMMMMMMMFFFFFFFFPPPPP_WWWWWMMMMDDDDMMMMMDDDMMWWWWWWMMMDDDDDDDDDDFFFFFFFFFFFFFFFMMMPPPPPPPPP_FFFFFFFFFFFWWWW
WWWWWW__PPMMMMMMMMMMMMMMMMMMMMFFFFFFFFPPP_WWWWWWWMMDDDDDDMMMMMDMMWWWWWWWWMMMMDDDDDDDDDFFFFFFFWWWWMMMMMMPPPPPPPPPFFFFFFFFFFFFWWWW
WWWWW_PPPMMMMFFFFFFFMMMMMMMMMMMMMFFFFFPP_WWWWWWWWMMMDDDDDDMMMMPPMMWWWWWWWWWMMMDDDDDDDDFFFFFWWWWWWWMMMMMMMPPPPPPPPFFFFFFFFFFFWWWW
WWWW_PPPMMMFFFFFFFFFFMMMMMMMMMMMMMMFFFFPP_WWWWWWWWMMDDDDDDMMMPPMMMWWWWWWWWWWMMMMDDDDDFFFFWWWWWWWWMMMMMMMMMMMMMPPPFFFFFFFFFFFWWWW
WWWW_PPPFFFFFFFSSSSFFFFMMMMMMMMMMMMMFFFFPP_WWWWWWWMMDDDDDMMMPPPMMWWWWWWWWWWWWWMMMPPPPPFFFFWWWWMMMMFFFFFMMMMMMMMFFFFFFFFFFFFWWWWW
WWWW_PPFFFFFFSSSSSSSFFFFFMMMMPPPPSMMFFFPPP_WWWWWWWMMMDDDMMMPPPPMMWWWWWWWWWWWWWMMPPPPPPPPFFFFFFFFFFFFFFFFMMMMMMMMMMFFFFFFFWWWWWWW
WWWW_PPPFFFFSSSSSSSSFFFFFFPPPPPPMMMPPPPPPP_WWWWWWWWMMDDMMMPPPPPPMMWWWWWWWWWWWMMMPPPPPPPPFFFFFFFFFFFFFFFFMMMMMMMMMDDDFFFFWWWWWWWW
WWWW_PPFFFFFFSSSSSSFFFFFFFPPPPPMMMPPPPPPP_WWWWWWWWWMMSMMMMMMPMMMMMWWWWWWWWWWWWMMPPPPPPPPPPPPPPPFFFFFFFFMMMMMMMMDDDDDDFFWWWWWWWWW
WWWW_PPFFFFFFFSSSSFFFFFFFPPPPPPMMMMPPPP__WWWWWWWWWMMSSMMMMMPPPMMMWWWWWWWWWWWWWWMMPPPPPPPPPPPPPPPPPPFFFFFFFFFFFDDDDDDDDFFWWWWWWWW
WWWW_PPFFFFFFFFFFFFFFFFFMMMMMMMMMMMMMMMWWWWWWWWWWWWMMSSMMMPPPMMMWWWWWWWWWWWWWWMMMPPPPPPPPPPPPPPPPPPPFFFFFFFFFDDDDDDDDFFFFWWWWWWW
WWWW_PPPFFFFFFFFFFFFFFMMMMMMMMMMMFFFFWWWWWWWWWWWWWWWMMSSMMMPPPMMMWWWWWWWWWWWWWWMMMPPPPPPPPPPPPPPPPPPFFFFFFFFFFDDDDDDFFFFFWWWWWWW
WWWWW_PPPFFFFFFFFFPPPMMMMMMFFFFFFFFFP_WWWWWWWWWWWWWWMMSSSSMMPPPMMWWWWWWWWWWWWWWWMMMPPPPPPPPFFFPPPPPFFFFFFFFFFFFDDDDFFFFFFFWWWWWW
WWWWWW__PPFFFFFFFPPPPPPMMMFFFFFFFFFPPP__WWWWWWWWWWWWWMMSSSSSSMMMWWWWWWWWWWWWWWWWWMM_PPPPPPFFFFFPPPFFFFMMMMMMMMFFFFFFFFFFFFFWWWWW
WWWWWWWW__PPFFFFFFFFPPPPPFFFFFFFFFPPPPPP_WWWWWWWWWWWWWMMMSSMMMWWWWWWWWWWWWWWWWWWWWWW__PPPFFFFFFFFFFFMMMPPPPPMMMMMMFFFFFFFFFFWWWW
WWWWWWWWWW_PPPFFFFFFFPPPPPPFFFFFPPPPPPP_WWWWWWWWWWWWWWWWMMMMWWWWWWWWWWWWWWWWWWWWWWWWWWFFFFFFFFFFFFFMMMPPPPPPPPPMMMMFFFFFFFFFWWWW
WWWWWWWWWWW_PPPPFFFFFFPPPFFFFFFPPPPPP__WWWWWWWWWWWWWWWWWWWWWWWWWWWWWWWWWWWWWWWWWWWWWWWWWFFFFFFFFFFFMMPPPFFFFFPPPMMMMMFFFFFFFWWWW
WWWWWWWWWWWW_PPPPPFFFFFFFFFFFFPPPP___WWWWWFFFFFFFWWWWWWWWWWWWWWWWWWWWWWWWWWWWWWWWWWWWWWWWWFFFFFFFFPPPPPFFFFFFFPPPPMMMFFFFFFFWWWW
WWWWWWWWWWWWW__PPPPFFFFFFFFFFPPPP_WWWWWWFFFFFFFWWWWWWWWWWWWWWWWWWWWWWWWWWWWWWWWWWWWWWWWWFFFFFFFFFPPPPPFFWWWWWFFPPPPMMMFFFFFFWWWW
WWWWWWWWWWWWWWW_PPPPPFFFFFFFFPPPPP_WWWW_PFFFFFWWWWWWWWWWWWWWWWWWWWWWWWWWWWWWWWWWWWWWWWFFFFFFFFFFPPPPPFFWWWWWWWFFPPPMMFFFFFFFWWWW
WWWWWWWWWWWWWWWWPPPPPPPFFFFFFFFPPPP____PPPFFFWWWWWWWWWWWWWWWWWWWWWWWWWWWWWWWWWWWWWWWWWWFFFFFFFFFFPPPFFWWWPPPWWWFFPPMMMFFFFFFWWWW
WWWWWWWWWWWWWWWWWWPPPPPPFFFFFFFFFPPPPPPPP__WWWWWWWWWWWWWWWWWWWWWWWWWWWWWWWWWWWWWWWWWWWWWWWFFFFFFFFPPFFWWWPPPDDDFFPPMMFFFFFFFWWWW
WWWWWWWWWWMMMMMMWWWWWWWWWFFFFFFFFFFFFPPP_WWWWWWWWWWWWWWWWWWWWWWWWWWWWWWWWWWWWWWWWWWWWWWWWFFFFFFFFFFFFFWWWPPPWWWFFPPMMFFFFFFFWWWW
WWWWWWWWWMMMFFFFFFWWWWWWWWWFFFFFFFFFFFPPP_WWWWWWWWWWWWWWWWWWWWWWWWWWWWWWWWWWWWWWWWWWWWWWWWFFFFFFFFFFFFFWWWWWWWFFPPMMFFFFFFFWWWWW
WWWWWWWWMMMFFFFFFFFFFWWWWWFFFFFFFFFFFPPPPP_WWWWWWWWWWWWWWWWWWWWWWWWWWWWWWWMMMMMMMMWWWWWWWWWFFFFFFFFFFFFFWWWWWFFFMMMMFFFFFFWWWWWW
WWWWWWWMMMFFFFFFFFPPPPWWWWWWFFFFFFFFPPPPPPP___WWWWWWWWWWWWWWWWWWWWWWWWWWMMMMMDDDDD__WWWWWWWWWFFFFFFFFFMMMMMFFFFFFFFFFFFFFFWWWWWW
WWWWWWMMMFFFFFFPPPPPPPPPPWWWWFFFFFFFPPPPPPPPPP_WWWWWWWWWWWWWWWWWWWWWWWW_DDDDDDDMMMMD_WWWWWWWFFFFFFFFFFFMMMMMFFFFFFFFFFFFFWWWWWWW
WWWWWMMMFFFFFFPPPPPPPPPPPPPWFFFFFFFPPPPPPFFPPPP_WWWWWWWWWWWWWWWWWWWWWWMMMMMMMMMMMMMMD_WWWWWWWFFFFFFFFFFFFMMMMPPPFFFFFFFFP_WWWWWW
WWWWMMMFFFFPPPPPPPPPFFFFPPPWFFFFFFFPPPPPFFFFPPPP_WWWWWWWWWWWWWWMMMMMMMMMMDDDDDDMMMMMM_WWWWWWWWWFFFFFFFFFFFMMMPPPPFFFFFFPPP__WWWW
WWWWMMMFFFPPPPPPPPFFFFFFFFFWWFFFFFPPPPPFFFFFFPPP_WWWWWWWWWWWMMMMMMMMDDDDDDDDDDDDDDMMMDMMWWWWWWFFFFFFFFFFFFFFMMPPPFFFFFPPPPP_WWWW
WWWWMMFFFFFPPPPPFFFFFFFFFFFFWWFFFFPPPPFFFFFFFFPPP_WWWWWWWWMMMMMMMMMDDMMMMMMMMMMMMDDMMDMMWWWWWWWFFFFFFFFFFFFFFMMPPPFFFFFPPPP_WWWW
WWWWFFFFFPPPPPPPPFFFFFFFFFFFMMMMFFFPPPPFFFFFFPPPP_WWWWWWWMMMMMMMMMDDMMMMDDDDDDDDMMDMMDMMMWWWWWWWWFFFFFFFFFFFFFMMPPFFFFFPPPP_WWWW
WWWWFFFFPPPPPPPPPPFFFFFFFFFMMMMMMMMPPPPPFFFFPPPPP_WWWWWWWWMMMMMMMMDMMMMMMMMMDDDMMMDDMDMMMMWWWWWWWFFFFFFFFFFFFFMMMPPFFFFFPPP_WWWW
WWWWFFFFFPPPPPPPPFFFFFFFFFMMMMMMMMMMMPPPPPPPPPP__WWWWWWWWWWW_PDDDDDMMMMMMMMMMDMMMMMDDDDMMMWWWWWWWWFFFFFFFFFFFFFMMPPPFFFFFP_WWWWW
WWWWFFFFFPPPPPPPFFFFFFFFFMMMMMMMMMMMMMMPPPPPP__WWWWWWWWWWW__PPPMMMDDMMMMMMMMMDMMMMMMMMFMMMMWWWWWWWWFFFFFFFFFFFFFMMFFFFFFFFWWWWWW
WWWWWWFFFFFPPPPPPFFFFFMMMMMDDDDDDDMMMMMMM____WWWWWWWWWFFF_PPPPPPMMMDDDDDMMMMMDMMMMMMMFFFMMMWWWWWWWWWWWFFFFFFFFPPPPFFFFFFFFWWWWWW
WWWWWWWFFFFFPPPPPPFFMMMDDDDDDDDDDDDMMMMMWWWWWWWWWWWWWFFFFFPPPPPMMMMMMMMMMMMMMDDDDDDDFFFFFMMMWWWWWWWWWWWWFFFFFPPPPPFFFFFFFFWWWWWW
WWWWWWFFFFFFPPPPPPPPPDDDDDDDDDDDDDDDMMMWWWWWWWWWWWWFFFFFFPPPPPPMMMMMMMPPPMMMMMMMMMMFFFFFFFMMWWWWWWWWWWWWWFFFFFFPPPPFFFFFFWWWWWWW
WWWWFFFFFFFFFPPPPPPPDDDDDDDDDDDDDD_MMWWWWWWWWWWWWFFFFFFPPPPPPPPMMFFFPPPPWWWWMMMMMMMMFFFFFMMWWWWWWWWWWWWWWWFFFFFFPPPPFFFWWWWWWWWW
WWWWFFFFFFFFFFFPPPPPDDDDDDDDDDD___WWWWWWFFFFFFFFFFFFFPPPPPPPPPMMFFFFFPPPPPWWWSSSSSMMMMFFMMWWWWWWWWWWWWWWFFFFFFFPPPPPPFFFWWWWWWWW
WWWWWFFFFFFFFFFFFPPDDDDDDDDDD__WWWWWWWFFFFFFFWWWWWWWPPPPPPPMMMMFFFFFFPPPPPWSSSSSPPPPMMMFWWWWWWWWWWWWWWWWWFFFFFFFPPPPFFFFFWWWWWWW
WWWWWWWWWFFFFFFFFFDDDDDDDDDD_WWWWWWWFFFFWWWWFFFFFFPPPPPPPMMMFFFFFFFFFFPPPWWSSSSPPPPPPMMP_WWWWWWWWWWWWWWWWFFFFFFFPPPFFFFFWWWWWWWW
WWWWWWWWWWWWWWWFFDDDDDDDDDD___WWWWWFFFFFFFFWWWWWWWWPPPPPMMFFFFFFFFFFFWWWWSSSSSPPPPPPMMMMP_WWWWWWWWWWWWWWWWFFFFPPPPFFFFFWWWWWWWWW
WWWWWWWWWWWW___DDDDDDDDDDD_WWWWWWWWWWFFFFFFFFFFFFFFFPPPMMFFFFFFFFWWWWWWWSSSSSPPPPPPMMMMM_WWWWWWWWWWWWWWFFWWFFFFPPPPFFFFFWWWWWWWW
WWWWWWWW____DDDDDDDDDDDDDDD__WWWWWFFFFFFFFWWWWFFFFFFFMMMFFFFFWWWWWWWWWWWWSSSPPPPPPPFFMMPP_WWWWWWWWWWWWFFFFWFFFFFPPFFFFFWWWWWWWWW
WWWWWW__DDDDPPPPPPDDDDDDDDDDDFFFFFWWWWWWWWWWWWWFFFFMMMFFFFFWWWWWWWWWWWWWPPPPPPPPPPPFFFMMPP_WWWWWWWWWWFFFFFWWFFFFFFFFFFWWWWWWWWWW
WWWWWWW_DDPPPPFFFFFDDDDDDDDDFFFFFFFFFFFFFFFWWWFFFMMFFFFFFFWWWWWWWWWWWFFFFPPPPPPPPPFFFFFMMMP_WWWWWWWWWWWFFFFWWFFFFFFFFFWWWWWWWWWW
WWWWWW_PPPPPFFFFFFFFFFDDDDDFFFFFFFFFFFFFFFFFWFFMMMFFFFFFFWWWWWWWFFFFFFFFFFPPPPPPPFFFFFFFFMMP_WWWWWWWWWFFFFFFWWFFFFFFFWWWWWWWWWWW
WWWWW_PPPPFFFFFFFFFFFFFFDDDDFFFFFFFFFFFFFFWWWWMMFFFFPPPPWWWWWWWWWWFFFFFFFFFPPPPPPFFFFFFFMMPP_WWWWWWWWWFFSFFFFWFFFFFFWWWWWWWWWWWW
WWWW_PPPPPPFFFFFFFFFFFFFFDDDDFFFFFFFFFFFWWWWWWWWWPPPPPPWWWWWWWWWWFFFFFFFFFFLLPLLFFFFFFFMMMMPP_WWWWWWWFFSSSFFFWWFFFFWWWWWWWWWWWWW
WWWW_PPPPMMMMFFFFFFFFFFFFDDDDDFFFFFFFWWWWWWWWWWWPPPPPPWWWWWWWWWWWWFFFFFFFFFLPPPLFFFFFFFMMMMMPP_WWWWWWFFFSSSFFWWFFFWWWWWWWWWWWWWW
WWWW_PPPPPMMMMMFFFFFFFFFDDDDDDDFFFFFFMMWWWWMMMMMPPPPPPWWWWWWWWWWWWWWFFFFFFFLPPPLFFFFFFFFMMMMMPP_WWWWWWFFFSSFFFWWWWWWWWWWWWWWWWWW
WWWW_PPPPPPPMMMMMFFFFFFFDDDDDDDDFFFFFMMMWWMMMMFFPPPPPWWPPPPWWWWWWWWWWWFFFFFLPPPLFFFFFFFFFFMMPPPP_WWWWWFFPPPPFFFWWWWWWWWWWWWWWWWW
WWWW_PPPPPPMMMMMMMMMFFFFDDDDDDDDPPFFFFMMMMMMMFFFFPPP_W_PPPPFFFFFWWWWWWWFFFFLLLLLFFFFFFFFFMMMPPPPP_WWWWWFFPPPPPP____WWWWWWWWWWWWW
WWWW_PPPPPPMMFFFFFMMMMMMMDDDDDPPPPPPFFFMMMMMFFFFFP__WW_PPPFFFFFFFFFFMMMMFFFFFFFFFFFFFFFFMMMPPPPP_WWWWWWWW_PPPPPPPPP_____WWWWWWWW
WWWWW__PPPMMFFFFFFFFMMMMMMMDDPPPPPPPPMMMMMMFFFFFFFWWWFFFPPPPPFFFFFFFFMMMMMMFFFFFFFFFFMMMMMMPPPP_WWWWWWWWWW_PPMMMMMPPPPPP__WWWWWW
WWWWWWW__PMMFFFFFPPPPPMMMMPPPPPPPPPPPPMMMMMMFFFFFWWWFFFFFPPPPPPFFFFFFFFMMMMMMMMFFFFMMMMMMMPPPPPP_WWWWWWWW_PPMMMFFMMMPPPP__WWWWWW
WWWWWWWWW_PMMFFFPPPPPPPPPPPPPPPPPPPPMMMMMMMFFFFFWWWFFFFFFFPPPPPPFFFFFFFFMMMMMMMMMMMMMMMMMPPPPPPP__WWWWWW_PPMMMFFFFMMPPP_WWWWWWWW
WWWWWWWW_PPPMMMPPPPPPPPPPPPPPPPPPPPMMMMMMMFFFFFWWWWFFFFFFPPPPPPPPPFFFFFSSSMMMMMMMMMMMSSSSSPPPPP_WWWWWWW_PPMMMFFFMFFMMP_WWWWWWWWW
WWWWWWW_PPPPMMPPPPPPPPPPPPPPPPPPPMMMMMMFFFFFFFFWWWWWFFFFPPPPPPPPPPFFFSSSSSSSSMMMMMMMSSSSSSSPPPPP_WWWWWWW_PPMMFFFFFMMMMP___WWWWWW
WWWWWWWW_PPPMMPPPPPPPPPPPPPPPPPPMMMMMMFFFFFFFFFWWWWFFFFFPPPPPPPPPPFFFSSSSSSSSSMMMMMSSSSSSSSSPPP_WWWWWWWWW_PPMMFFFFMMPPPPP_WWWWWW
WWWWWWWWW__PPPPPPPPPPPPPPPPPPPPPPMMMMFFFFFFFFFWWWWWWFFFFFPPPPPPPPFFFSSSSSSSSSSSMMMSSSSSSSSSSSP_WWWWWWWWWW_PPMMMFMMMPPPPP_WWWWWWW
WWWWWWWWWWW_PPPPPPPPPPPPPP___PPMMMMMFFFFFFFFFWWWWWWWFFFFFFFPPPPPPFFFFSSSSSSSSSSS__SSSSSSSSSSS_WWWWWWWWWWWW_PPMMFMMPPPPP_WWWWWWWW
WWWWWWWWWW_PPPPPPPPPPPPPP_WWWMMMMMMMMFFFFFFFWWWWWWWWWFFFFFFFFPPPFFFFFSSSSSSSSSS_WW_SSSSSSSSS_WWWWWWWWWWWWW_PPPPPPPP____WWWWWWWWW
WWWWWWWWWWW_PPPPPPPPPPPP_WWWWWFFFFFFFFFFFFFWWWWWWWWWWWWFFFFFFFFFFFFFSSSSSSSSSS_WWWW___SSSS__WWWWWWWWWWWWWW_PPPPPS__WWWWWWWWWWWWW
WWWWWWWWWWWW_PPPPPPPPPPPP_WWWFFFFFFFFFFFFWWWWWWWWWWWWWWWWFFFFFFFFFFSSSSSSSSSS_WWWWWWWW____WWWWWWWWWWWWWWWWW_PPPS_WWWWWWWWWWWWWWW
WWWWWWWWWWWWW__PPPPPPPPPP_W__PPPPFFFFFWWWWWWWWWWWWWWWWWWWWWFFFFFSSSSSSSSSSSS_WWWWWWWWWWWWWWWWWWWWWWWWWWWWWWW_PS_WWWWWWWWWWWWWWWW
WWWWWWWWWWWWWWW_PPPPPPP__WWW_______WWWWWWWWWWWWWWWWWWWWWWWWWWWW_SSSSSSSSSS__WWWWWWWWWWWWWWWWWWWWWWWWWWWWWWWW_SS_WWWWWWWWWWWWWWWW
WWWWWWWWWWWWWWWW_______WWWWWWWWWWWWWWWWWWWWWWWWWWWWWWWWWWWWWWWWW__________WWWWWWWWWWWWWWWWWWWWWWWWWWWWWWWWWW___WWWWWWWWWWWWWWWWW
WWWWWWWWWWWWWWWWWWWWWWWWWWWWWWWWWWWWWWWWWWWWWWWWWWWWWWWWWWWWWWWWWWWWWWWWWWWWWWWWWWWWWWWWWWWWWWWWWWWWWWWWWWWWWWWWWWWWWWWWWWWWWWWW
WWWWWWWWWWWWWWWWWWWWWWWWWWWWWWWWWWWWWWWWWWWWWWWWWWWWWWWWWWWWWWWWWWWWWWWWWWWWWWWWWWWWWWWWWWWWWWWWWWWWWWWWWWWWWWWWWWWWWWWWWWWWWWWW
WWWWWWWWWWWWWWWWWWWWWWWWWWWWWWWWWWWWWWWWWWWWWWWWWWWWWWWWWWWWWWWWWWWWWWWWWWWWWWWWWWWWWWWWWWWWWWWWWWWWWWWWWWWWWWWWWWWWWWWWWWWWWWWW
WWWWWWWWWWWWWWWWWWWWWWWWWWWWWWWWWWWWWWWWWWWWWWWWWWWWWWWWWWWWWWWWWWWWWWWWWWWWWWWWWWWWWWWWWWWWWWWWWWWWWWWWWWWWWWWWWWWWWWWWWWWWWWWW
